10,10
13,13,9,5,13,9,3,3,1,7
8,4,12,12,8,2,3,3,0,7
8,4,8,4,12,9,3,1,2,7
8,2,0,6,8,4,11,2,1,5
42,3,2,3,2,2,3,1,2,6
9,1,3,7,9,1,3,2,1,7
10,0,3,5,12,10,3,3,2,7
9,4,9,4,12,9,1,1,5,13
8,4,12,8,4,24,2,0,0,4
10,2,2,2,2,2,3,2,2,6
