############..
#SS..#.....###
#SS..#.B..B..#
#SS..#B####..#
#SS....A.##..#
#SS..#.#..B.##
######.##B.B.#
..#.B..B.B.B.#
..#....#.....#
..############
