....#####..........
....#...#..........
....#B..#..........
..###..B##.........
..#..B.B.#.........
###.#.##.#...######
#...#.##.#####..SS#
#.B..B..........SS#
#####.###.#A##..SS#
....#.....#########
....#######........
